"filename", "language", "Go Checksum File", "Go", "YAML", "Go Module File", "Ignore", "comment", "blank", "total"
"d:\working\flagger-backend\.dockerignore", "Ignore", 0, 0, 0, 0, 1, 0, 0, 1
"d:\working\flagger-backend\appconfig\config.go", "Go", 0, 30, 0, 0, 0, 0, 7, 37
"d:\working\flagger-backend\config.yaml", "YAML", 0, 0, 7, 0, 0, 0, 2, 9
"d:\working\flagger-backend\dbhandlers\base.go", "Go", 0, 28, 0, 0, 0, 0, 6, 34
"d:\working\flagger-backend\dbhandlers\baseaction.go", "Go", 0, 89, 0, 0, 0, 0, 15, 104
"d:\working\flagger-backend\dbhandlers\flaggeraction.go", "Go", 0, 171, 0, 0, 0, 4, 15, 190
"d:\working\flagger-backend\dbhandlers\useraction.go", "Go", 0, 154, 0, 0, 0, 2, 16, 172
"d:\working\flagger-backend\go.mod", "Go Module File", 0, 0, 0, 25, 0, 0, 3, 28
"d:\working\flagger-backend\go.sum", "Go Checksum File", 63, 0, 0, 0, 0, 0, 1, 64
"d:\working\flagger-backend\main.go", "Go", 0, 7, 0, 0, 0, 0, 3, 10
"d:\working\flagger-backend\models\db_query_type.go", "Go", 0, 9, 0, 0, 0, 0, 4, 13
"d:\working\flagger-backend\models\db_type.go", "Go", 0, 74, 0, 0, 0, 3, 12, 89
"d:\working\flagger-backend\models\post_form_type.go", "Go", 0, 27, 0, 0, 0, 2, 3, 32
"d:\working\flagger-backend\models\return_data_type.go", "Go", 0, 40, 0, 0, 0, 1, 6, 47
"d:\working\flagger-backend\routers\auth.go", "Go", 0, 115, 0, 0, 0, 3, 11, 129
"d:\working\flagger-backend\routers\flagger.go", "Go", 0, 368, 0, 0, 0, 6, 19, 393
"d:\working\flagger-backend\routers\router.go", "Go", 0, 55, 0, 0, 0, 3, 11, 69
"d:\working\flagger-backend\routers\user.go", "Go", 0, 183, 0, 0, 0, 0, 8, 191
"d:\working\flagger-backend\tools\array_to_num.go", "Go", 0, 20, 0, 0, 0, 0, 4, 24
"d:\working\flagger-backend\tools\flag_join_auth.go", "Go", 0, 36, 0, 0, 0, 0, 5, 41
"d:\working\flagger-backend\tools\flag_join_auth_test.go", "Go", 0, 16, 0, 0, 0, 0, 5, 21
"d:\working\flagger-backend\tools\time.go", "Go", 0, 27, 0, 0, 0, 0, 5, 32
"Total", "-", 63, 1449, 7, 25, 1, 24, 161, 1730