"filename", "language", "Go Module File", "Go", "Ignore", "YAML", "Go Checksum File", "comment", "blank", "total"
"d:\working\flagger-backend\.dockerignore", "Ignore", 0, 0, 1, 0, 0, 0, 0, 1
"d:\working\flagger-backend\appconfig\config.go", "Go", 0, 30, 0, 0, 0, 0, 7, 37
"d:\working\flagger-backend\config.yaml", "YAML", 0, 0, 0, 7, 0, 0, 2, 9
"d:\working\flagger-backend\dbhandlers\base.go", "Go", 0, 28, 0, 0, 0, 0, 6, 34
"d:\working\flagger-backend\dbhandlers\baseaction.go", "Go", 0, 30, 0, 0, 0, 0, 7, 37
"d:\working\flagger-backend\dbhandlers\flaggeraction.go", "Go", 0, 45, 0, 0, 0, 0, 7, 52
"d:\working\flagger-backend\dbhandlers\useraction.go", "Go", 0, 37, 0, 0, 0, 0, 5, 42
"d:\working\flagger-backend\go.mod", "Go Module File", 25, 0, 0, 0, 0, 0, 3, 28
"d:\working\flagger-backend\go.sum", "Go Checksum File", 0, 0, 0, 0, 63, 0, 1, 64
"d:\working\flagger-backend\main.go", "Go", 0, 7, 0, 0, 0, 0, 3, 10
"d:\working\flagger-backend\models\db_query_type.go", "Go", 0, 8, 0, 0, 0, 0, 3, 11
"d:\working\flagger-backend\models\db_type.go", "Go", 0, 66, 0, 0, 0, 3, 10, 79
"d:\working\flagger-backend\models\post_form_type.go", "Go", 0, 28, 0, 0, 0, 0, 3, 31
"d:\working\flagger-backend\models\return_data_type.go", "Go", 0, 7, 0, 0, 0, 0, 3, 10
"d:\working\flagger-backend\routers\auth.go", "Go", 0, 58, 0, 0, 0, 1, 7, 66
"d:\working\flagger-backend\routers\flagger.go", "Go", 0, 56, 0, 0, 0, 0, 8, 64
"d:\working\flagger-backend\routers\router.go", "Go", 0, 12, 0, 0, 0, 0, 6, 18
"d:\working\flagger-backend\routers\user.go", "Go", 0, 68, 0, 0, 0, 0, 4, 72
"d:\working\flagger-backend\tools\flag_join_auth.go", "Go", 0, 17, 0, 0, 0, 0, 4, 21
"d:\working\flagger-backend\tools\time.go", "Go", 0, 22, 0, 0, 0, 0, 4, 26
"Total", "-", 25, 519, 1, 7, 63, 4, 93, 712