"filename", "language", "Go Module File", "Go", "Go Checksum File", "YAML", "Ignore", "comment", "blank", "total"
"d:\working\flagger-backend\.dockerignore", "Ignore", 0, 0, 0, 0, 1, 0, 0, 1
"d:\working\flagger-backend\appconfig\config.go", "Go", 0, 30, 0, 0, 0, 0, 7, 37
"d:\working\flagger-backend\config.yaml", "YAML", 0, 0, 0, 7, 0, 0, 2, 9
"d:\working\flagger-backend\dbhandlers\base.go", "Go", 0, 28, 0, 0, 0, 0, 6, 34
"d:\working\flagger-backend\dbhandlers\baseaction.go", "Go", 0, 50, 0, 0, 0, 0, 12, 62
"d:\working\flagger-backend\dbhandlers\flaggeraction.go", "Go", 0, 136, 0, 0, 0, 0, 10, 146
"d:\working\flagger-backend\dbhandlers\useraction.go", "Go", 0, 40, 0, 0, 0, 0, 5, 45
"d:\working\flagger-backend\go.mod", "Go Module File", 25, 0, 0, 0, 0, 0, 3, 28
"d:\working\flagger-backend\go.sum", "Go Checksum File", 0, 0, 63, 0, 0, 0, 1, 64
"d:\working\flagger-backend\main.go", "Go", 0, 7, 0, 0, 0, 0, 3, 10
"d:\working\flagger-backend\models\db_query_type.go", "Go", 0, 9, 0, 0, 0, 0, 3, 12
"d:\working\flagger-backend\models\db_type.go", "Go", 0, 68, 0, 0, 0, 3, 10, 81
"d:\working\flagger-backend\models\post_form_type.go", "Go", 0, 29, 0, 0, 0, 0, 3, 32
"d:\working\flagger-backend\models\return_data_type.go", "Go", 0, 8, 0, 0, 0, 0, 2, 10
"d:\working\flagger-backend\routers\auth.go", "Go", 0, 57, 0, 0, 0, 1, 7, 65
"d:\working\flagger-backend\routers\flagger.go", "Go", 0, 219, 0, 0, 0, 0, 12, 231
"d:\working\flagger-backend\routers\router.go", "Go", 0, 25, 0, 0, 0, 0, 7, 32
"d:\working\flagger-backend\routers\user.go", "Go", 0, 68, 0, 0, 0, 0, 4, 72
"d:\working\flagger-backend\tools\flag_join_auth.go", "Go", 0, 17, 0, 0, 0, 0, 4, 21
"d:\working\flagger-backend\tools\flag_join_auth_test.go", "Go", 0, 16, 0, 0, 0, 0, 5, 21
"d:\working\flagger-backend\tools\time.go", "Go", 0, 27, 0, 0, 0, 0, 5, 32
"Total", "-", 25, 834, 63, 7, 1, 4, 111, 1045