"filename", "language", "Go", "Go Module File", "Go Checksum File", "YAML", "Ignore", "comment", "blank", "total"
"d:\working\flagger-backend\.dockerignore", "Ignore", 0, 0, 0, 0, 1, 0, 0, 1
"d:\working\flagger-backend\appconfig\config.go", "Go", 30, 0, 0, 0, 0, 0, 7, 37
"d:\working\flagger-backend\config.yaml", "YAML", 0, 0, 0, 7, 0, 0, 2, 9
"d:\working\flagger-backend\dbhandlers\base.go", "Go", 28, 0, 0, 0, 0, 0, 6, 34
"d:\working\flagger-backend\dbhandlers\baseaction.go", "Go", 72, 0, 0, 0, 0, 0, 14, 86
"d:\working\flagger-backend\dbhandlers\flaggeraction.go", "Go", 143, 0, 0, 0, 0, 0, 14, 157
"d:\working\flagger-backend\dbhandlers\useraction.go", "Go", 124, 0, 0, 0, 0, 0, 12, 136
"d:\working\flagger-backend\go.mod", "Go Module File", 0, 25, 0, 0, 0, 0, 3, 28
"d:\working\flagger-backend\go.sum", "Go Checksum File", 0, 0, 63, 0, 0, 0, 1, 64
"d:\working\flagger-backend\main.go", "Go", 7, 0, 0, 0, 0, 0, 3, 10
"d:\working\flagger-backend\models\db_query_type.go", "Go", 9, 0, 0, 0, 0, 0, 4, 13
"d:\working\flagger-backend\models\db_type.go", "Go", 74, 0, 0, 0, 0, 3, 12, 89
"d:\working\flagger-backend\models\post_form_type.go", "Go", 29, 0, 0, 0, 0, 0, 3, 32
"d:\working\flagger-backend\models\return_data_type.go", "Go", 40, 0, 0, 0, 0, 0, 6, 46
"d:\working\flagger-backend\routers\auth.go", "Go", 57, 0, 0, 0, 0, 1, 7, 65
"d:\working\flagger-backend\routers\flagger.go", "Go", 335, 0, 0, 0, 0, 1, 16, 352
"d:\working\flagger-backend\routers\router.go", "Go", 25, 0, 0, 0, 0, 0, 7, 32
"d:\working\flagger-backend\routers\user.go", "Go", 88, 0, 0, 0, 0, 0, 7, 95
"d:\working\flagger-backend\tools\array_to_num.go", "Go", 20, 0, 0, 0, 0, 0, 4, 24
"d:\working\flagger-backend\tools\flag_join_auth.go", "Go", 17, 0, 0, 0, 0, 0, 4, 21
"d:\working\flagger-backend\tools\flag_join_auth_test.go", "Go", 16, 0, 0, 0, 0, 0, 5, 21
"d:\working\flagger-backend\tools\time.go", "Go", 27, 0, 0, 0, 0, 0, 5, 32
"Total", "-", 1141, 25, 63, 7, 1, 5, 142, 1384